32,32,32,32,32,32,32,32,32,32,32,32,32,32,32,32,32,32,32,32,32,32,32,32,32,32,32,32,32,32,32,32,32,32,32,32,32,32,32,32,32,32,132,132,132,132,32,32,32,32,32,32,32,32,32,32,32,32,32,32,32,32,32,32,32,32,32,32,32,32,32,32,32,32,32,32,32,32,32,32
32,32,32,32,32,32,32,32,32,32,32,32,32,32,32,32,32,32,32,32,32,132,132,132,32,32,32,32,32,32,32,32,32,32,32,32,32,32,32,32,32,32,132,132,132,32,32,32,32,32,32,32,32,32,32,32,32,32,32,32,32,32,32,32,32,32,32,32,32,32,32,32,32,32,32,32,32,32,32,32
32,132,132,132,132,132,132,132,132,132,32,32,32,32,32,32,32,32,32,32,132,132,132,132,132,132,32,32,32,32,32,32,32,32,32,32,32,32,32,32,32,32,32,32,32,32,32,32,32,32,32,32,32,32,32,32,32,32,32,32,32,32,32,32,32,32,32,32,32,32,32,32,32,32,32,32,32,32,32,32
32,132,132,132,132,132,132,132,32,32,32,32,32,32,32,32,32,32,32,32,132,132,132,132,132,132,32,32,32,32,32,32,32,32,32,32,32,32,32,32,32,32,32,32,32,32,32,32,32,32,32,32,32,32,32,32,32,132,132,132,132,132,132,132,32,32,32,32,32,32,32,32,32,32,32,32,32,32,32,32
32,132,132,132,132,132,32,32,32,32,32,32,32,32,32,32,32,32,32,32,32,32,32,32,32,32,32,32,32,32,32,32,32,32,32,32,32,32,32,32,32,32,32,32,32,32,32,32,32,32,32,32,32,32,32,32,32,32,132,132,132,132,132,32,32,32,32,32,32,32,32,32,32,32,32,32,32,32,32,32
32,32,132,132,132,32,32,32,32,32,32,32,32,32,32,32,32,32,32,32,32,32,32,32,32,32,32,32,32,32,32,32,32,32,32,32,32,32,32,32,32,32,32,32,32,32,32,32,32,32,32,32,32,32,32,32,32,32,32,32,32,32,32,32,32,32,32,32,32,32,32,32,32,32,32,32,32,32,32,32
32,32,132,132,132,32,32,32,32,32,32,32,32,32,32,32,32,32,32,132,132,132,32,32,32,32,32,32,32,32,32,32,32,32,32,32,32,32,32,32,32,32,32,32,32,32,32,32,32,32,32,32,32,32,32,32,32,32,32,32,32,32,32,32,32,32,32,32,32,32,32,132,132,132,32,32,32,132,132,32
32,32,32,132,32,32,32,32,32,32,32,32,32,32,32,32,32,32,132,132,132,132,32,32,32,32,32,32,32,32,32,32,32,32,32,32,32,32,32,32,32,32,32,32,132,132,32,32,32,32,32,32,32,32,32,32,32,32,32,32,32,32,32,32,32,32,32,32,32,32,132,132,132,132,32,32,32,132,132,132
32,32,32,32,32,32,32,32,32,32,32,32,32,32,32,32,32,32,132,132,132,132,32,32,32,32,32,32,32,32,32,32,32,32,32,32,32,32,32,32,32,32,32,132,132,132,132,132,132,132,32,32,32,32,32,32,32,32,32,32,32,32,32,32,32,32,32,32,32,32,132,132,132,132,32,32,32,132,132,132
32,32,32,32,32,32,32,32,32,32,32,32,32,32,32,32,32,32,132,132,132,132,32,32,32,32,32,32,32,32,32,32,32,32,32,32,32,32,32,32,32,32,32,132,132,132,132,132,132,132,32,32,32,32,32,32,32,32,32,32,32,32,32,32,32,32,32,32,32,32,132,132,132,132,32,32,32,132,132,132
32,32,32,32,32,32,32,32,32,32,32,32,32,32,32,32,32,32,132,132,132,132,32,32,32,32,32,32,32,32,32,32,32,32,32,32,32,32,32,32,32,32,32,132,132,132,132,132,132,132,32,32,32,32,32,32,32,32,32,32,32,32,32,32,32,32,32,32,32,32,132,132,132,132,32,32,32,132,32,32
32,32,32,32,32,32,32,32,32,32,32,32,32,32,32,32,32,32,132,132,132,132,32,32,32,32,32,32,32,32,32,32,32,32,32,32,32,32,32,32,32,32,32,132,132,132,132,132,132,32,32,32,32,32,32,32,32,32,32,32,32,32,32,32,32,32,32,32,32,32,132,132,132,32,32,32,32,32,32,32
32,32,32,32,32,32,32,32,32,32,32,32,32,32,32,32,32,32,32,132,132,132,32,32,32,32,32,132,132,132,32,32,32,32,32,32,32,32,32,32,32,32,32,32,32,32,32,32,32,32,32,32,32,32,32,32,32,32,32,32,32,32,32,32,32,32,32,32,32,32,32,132,132,32,32,32,32,32,32,32
32,32,32,32,32,32,32,32,32,32,32,32,32,32,32,32,32,32,32,32,132,32,32,32,32,32,32,132,132,132,132,32,32,32,32,32,32,32,32,32,32,32,32,32,32,32,32,32,32,32,32,32,32,32,32,32,32,32,32,32,32,32,32,32,32,32,32,32,32,32,32,32,32,32,32,32,32,32,32,32
32,32,32,32,32,32,32,32,32,32,32,32,32,32,32,32,32,32,32,32,32,32,32,32,32,32,32,32,132,132,32,32,32,32,32,32,32,32,32,32,32,32,32,32,32,32,32,32,32,32,32,32,32,32,32,32,32,32,32,32,32,32,32,32,32,32,32,32,32,32,32,32,32,32,32,32,32,32,32,32
32,32,32,32,32,32,32,32,32,32,32,32,32,32,32,32,32,32,32,32,32,32,32,32,32,32,32,32,32,32,32,32,32,32,32,32,32,32,32,32,32,32,32,32,32,32,32,32,32,32,32,32,32,32,32,32,32,32,32,32,132,132,32,32,32,32,32,32,32,32,32,32,32,32,32,32,32,32,32,32
32,32,32,32,32,32,32,32,32,32,32,32,32,32,32,32,32,32,32,32,32,32,32,32,32,32,32,32,32,32,32,32,32,32,32,32,32,32,32,32,32,32,32,32,32,32,32,32,32,32,32,32,32,32,32,32,32,32,32,132,132,132,32,32,32,32,32,32,32,32,32,32,32,32,32,32,32,32,32,32
32,32,32,32,32,32,32,32,32,32,32,32,32,32,32,32,32,32,32,32,32,32,32,32,32,32,32,32,32,32,32,32,32,32,32,32,32,32,32,132,132,132,132,132,32,32,32,32,32,32,32,32,32,32,32,32,32,32,32,132,132,132,32,32,32,32,32,32,32,32,32,32,32,32,32,32,32,32,32,32
32,32,32,32,32,32,32,32,32,32,32,32,32,32,32,32,32,32,32,32,32,32,32,32,32,32,32,32,32,32,32,32,32,32,32,132,132,132,132,132,132,132,132,132,132,132,32,32,32,32,32,32,32,32,32,32,32,32,32,132,132,132,32,32,32,32,32,32,32,32,32,32,32,32,32,32,32,32,132,32
32,32,32,32,32,32,32,32,32,32,32,32,32,32,32,32,32,32,32,32,32,32,32,32,32,32,32,32,32,32,32,32,32,32,32,32,32,132,132,132,132,132,132,132,132,32,32,32,32,32,32,32,32,32,32,32,32,32,32,132,132,32,32,32,32,32,32,32,32,32,32,32,32,32,32,32,32,132,132,132
32,32,32,32,32,32,32,32,32,32,32,32,32,32,32,32,32,32,32,32,32,32,32,32,32,32,32,32,32,32,32,32,32,32,32,32,32,32,32,32,32,32,132,132,132,32,32,32,32,32,32,32,32,32,32,32,32,32,32,32,32,32,32,32,32,32,32,32,32,32,32,32,32,32,32,32,32,132,132,132
32,32,32,32,32,32,132,132,132,132,32,32,32,32,32,32,32,32,32,32,32,32,32,32,32,32,32,32,32,32,32,32,32,32,32,32,32,32,32,32,32,32,32,32,32,32,32,32,32,32,32,32,32,32,32,32,32,32,32,32,32,32,32,32,32,32,32,32,32,32,32,32,32,32,32,32,132,132,132,32
32,32,32,32,32,32,132,132,132,132,132,32,32,32,32,32,32,32,32,32,32,32,32,32,32,32,32,32,32,32,32,32,32,32,32,32,32,32,32,32,32,32,32,32,32,32,32,32,32,32,32,32,32,32,32,32,32,32,32,32,32,32,32,32,32,32,32,32,32,32,32,32,32,32,32,32,132,32,132,32
32,32,32,32,32,32,32,32,32,32,32,32,32,32,32,32,32,32,32,32,32,32,32,32,32,32,32,32,32,32,32,32,32,32,32,32,32,32,32,32,32,32,32,32,32,32,32,32,32,32,32,32,32,32,32,32,32,32,32,32,32,32,32,32,32,32,32,32,32,32,32,32,32,32,32,32,132,32,32,32
32,32,32,32,132,32,132,132,32,32,32,32,32,32,32,32,32,32,32,32,32,32,32,32,32,32,32,32,32,32,32,32,32,32,32,32,32,32,32,32,32,32,32,32,32,32,32,32,32,32,32,32,32,32,32,32,32,32,32,32,32,32,32,32,32,32,32,32,32,32,32,32,32,32,32,32,32,32,32,32
32,32,32,32,32,132,132,132,32,32,32,32,32,32,32,32,32,32,32,32,32,32,32,32,32,32,32,32,32,32,32,32,32,32,32,32,32,32,32,32,32,32,32,32,32,32,32,32,32,32,32,32,32,32,32,32,32,32,32,32,32,32,32,32,32,32,32,32,32,32,32,32,32,32,32,32,32,32,32,32
